{
  "levels":[
    {
       "tiles":[
        [16, 0, 0, 0, 0, 0, 0, 0, 0, 16],
        [3, 100, 10, 8, 8, 8, 8, 8, 8, 1],
        [3, 8, 8, 8, 8, 8, 8, 8, 8, 1],
        [3, 10, 10, 8, 8, 10, 8, 8, 8,  1],
        [3, 8, 8, 8, 10, 10, 8, 10, 10, 1],
        [3, 8, 8, 8, 8, 10, 8, 8, 8, 1],
        [3, 8, 10, 8, 8, 8, 8, 10, 9, 17],
        [16, 2, 2, 2, 2, 2, 2, 2, 2, 16]
      ]
    },
    {
      "tiles":[
        [16, 0, 0, 0, 0, 0, 0, 0, 0, 16],
        [3, 8, 8, 8, 8, 8, 8, 8, 8, 1],
        [3, 8, 8, 10, 14, 8, 8, 8, 8, 1],
        [3, 8, 10, 10, 8, 8, 8, 8, 8, 1],
        [3, 12, 8, 8, 15, 8, 8, 10, 12, 1],
        [3, 8, 10, 8, 8, 8, 8, 10, 9, 17],
        [3, 100, 10, 8, 8, 8, 8, 8, 8, 1],
        [16, 2, 2, 2, 2, 2, 2, 2, 2, 16]
      ]
    },
    {
      "tiles":[
        [16, 0, 0, 0, 0, 0, 0, 0, 0, 16],
        [3, 8, 8, 8, 8, 10, 8, 8, 8, 1],
        [3, 8, 10, 8, 8, 14, 8, 10, 9, 17],
        [3, 8, 8, 8, 4, 5, 8, 10, 8,  1],
        [3, 8, 12, 8, 7, 6, 8, 13, 8, 1],
        [3, 8, 8, 8, 8, 10, 8, 8, 8, 1],
        [3, 100, 8, 8, 8, 15, 8, 8, 8, 1],
        [16, 2, 2, 2, 2, 2, 2, 2, 2, 16]
      ]
    },
    {
      "tiles":[
        [16, 0, 0, 0, 0, 0, 0, 0, 0, 0, 0, 0, 0, 0, 0, 0, 0, 16],
        [3, 8, 8, 15, 8, 8, 8, 12, 8, 8, 8, 8, 8, 10, 8, 8, 14, 1],
        [3, 8, 100, 10, 8, 8, 8, 10, 10, 8, 8, 8, 10, 10, 8, 8, 8, 1],
        [3, 8, 15, 10, 8, 4, 5, 10, 8, 8, 8, 8, 8, 10, 10, 8, 14, 1],
        [3, 8, 8, 8, 8, 7, 6, 8, 8, 8, 12, 8, 8, 8, 8, 13, 14, 1],
        [3, 10, 10, 15, 10, 13, 4, 5, 10, 10, 8, 8, 8, 8, 4, 5, 8, 1],
        [3, 8, 8, 8, 8, 10, 7, 6, 12, 8, 8, 8, 8, 8, 7, 6, 8, 1],
        [3, 8, 14, 8, 8, 8, 8, 8, 8, 8, 8, 8, 14, 8, 8, 8, 8, 1],
        [3, 8, 10, 8, 8, 8, 8, 8, 8, 10, 8, 13, 13, 8, 10, 10, 10, 1],
        [3, 8, 8, 8, 8, 8, 10, 10, 8, 8, 8, 10, 10, 8, 8, 8, 8, 1],
        [3, 8, 13, 10, 8, 8, 13, 10, 13, 14, 8, 10, 13, 4, 5, 8, 8, 1],
        [3, 8, 8, 10, 8, 8, 8, 8, 8, 4, 5, 8, 8, 7, 6, 10, 10, 1],
        [3, 8, 8, 8, 8, 12, 8, 8, 8, 7, 6, 8, 8, 10, 8, 8, 9, 17],
        [16, 2, 2, 2, 2, 2, 2, 2, 2, 2, 2, 2, 2, 2, 2, 2, 2, 16]
      ]
    },

    {
      "tiles":[
        [16,0,0,0,0,0,0,0,0,0,0,0,0,0,0,0,0,0,0,0,0,16],
        [3,100,8,10,8,8,8,8,8,8,10,10,8,8,8,4,5,8,8,8,8,1],
        [3,12,8,11,8,8,8,8,8,8,8,8,8,8,8,7,6,8,8,10,8,1],
        [3,25,8,8,8,8,21,8,12,8,8,8,8,21,8,8,8,8,10,8,8,1],
        [3,10,14,8,8,10,8,8,8,8,8,8,8,8,10,8,8,8,8,8,8,1],
        [3,8,13,13,10,10,11,10,8,10,10,12,8,8,8,8,8,8,8,8,8,1],
        [3,8,8,8,8,8,11,4,5,8,8,8,8,8,8,8,12,8,10,8,8,1],
        [3,8,21,8,8,8,8,7,6,8,8,8,11,10,10,8,8,8,8,8,8,1],
        [3,8,8,11,10,8,8,8,8,8,11,10,10,8,8,8,8,8,8,8,21,1],
        [3,8,25,8,8,8,8,8,25,8,8,8,8,8,8,8,8,8,8,10,8,1],
        [3,8,8,8,8,10,10,8,8,21,8,8,8,8,11,8,8,13,8,8,12,1],
        [3,8,8,8,8,8,8,13,8,8,8,8,14,8,11,8,8,8,8,8,8,1],
        [3,8,8,8,21,8,8,8,8,11,8,4,5,8,8,8,8,8,8,8,8,1],
        [3,10,14,8,8,13,8,8,8,10,8,7,6,8,8,14,8,25,8,10,10,1],
        [3,8,10,8,8,8,8,25,8,11,8,8,21,8,8,8,8,8,8,11,9,17],
        [3,8,8,8,8,8,8,8,8,10,8,8,8,8,8,8,13,8,8,8,8,1],
        [16,2,2,2,2,2,2,2,2,2,2,2,2,2,2,2,2,2,2,2,2,16]
      ]
    }

    ]
}